Gg, Gg, Rp, Gg, Gg, Gg, Gg, Gg, Gg, Gg, Hh, Gg, Gll^Fp, Gg, Hh, Gg, Gg, Gg, Gg, Gg, Wot, Wot, Wot, Wot, Wot, Gg, Gg, Gg, Gg, Gg, Gg, Gg
Gg, Gg, Gg, Rp, Rp, Gg, Gg, Gg, Gg, Hh, Hh, Gll^Fp, Gll^Fp, Gll^Fp, Gg, Hh, Gg, Gg, Gg, Gg, Gg, Gg, Wot, Wot, Wot, Wot, Gg, Gg, Gg, Gg, Gg, Gg
Gg, Gg, Gg, Gg, Rp, Rr^Wm, Gs^Vh, Gg, Hh, Hh, Gll^Fp, Gll^Fp, Gg, Gg, Dd, Gg, Kh, Gg, Gg, Gg, Gg, Gg, Gg, Wot, Wot, Wot, Gg, Gs^Vh, Re^Gvs, Re^Gvs, Re^Gvs, Gg
Gg, Gg, Gg, Gg, Gg, Rp, Rp, Rp, Rp, Hh, Gg, Gg, Gg, Gg, Ch, Dd, Dd, Ch, Ch, Gg, Dd, Gg, Gg, Wot, Wot, Wot, Gg, Re^Gvs, Re^Gvs, Re^Gvs, Re^Gvs, Re^Gvs
Gg, Gg, Hh, Gg, Hh, Hh, Hh, Hh, Gg, Rp, Rp, Gg, Ch, Ch, Rd, Dd, Dd, Rd, Rd, Ch, Dd, Dd, Wot, Wot, Wot, Wot, Gg, Re^Gvs, Re^Gvs, Re^Gvs, Re^Gvs, Re^Gvs
Gg, Hh, Gll^Fp, Hh, Hh, Gll^Fp, Gg, Gg, Dd, Dd, Ch, Rr^Pr/, Rp, Rd, Rd, Dd, Dd, Rd, Rd, Rd, Dd^Fdw, Ch, Qxe, Wot, Wot, Gg, Re^Gvs, Re^Gvs, Re^Gvs, Re^Gvs, Re^Gvs, Re^Gvs
Gg, Hh, Gll^Fp, Gll^Fp, Hh, Gg, Gg, Gg, Ch, Dd, Dd, Rr, Rr, Rp, Rp, Rd^Dr, Dd, Rd, Rd, Dd^Fdw, Qxe, Qxe, Qxe, Qxe, Dd, Dd, Gg, Re^Gvs, Re^Gvs, Re^Gvs, Re^Gvs, Re^Gvs
Gg, Gll^Fp, Hh, Hh, Gg, Gg, 3 Kh, Ch, Rr, Rr, Dd, Dd, Dd, Rp, Rb, Rp, Dd, Rd, Dd^Fdw, Dd^Fdw, Qxe, Qxe, Dd^Fdw, Dd^Fdw, Rd, Dd, Kh, Gg, Gg, Re^Gvs, Gg, Gg
Hh, Gll^Fp, Hh, Hh, Dd, Dd, Dd, Dd, Rp, Rr, Rp, Rp, Rd, Dd, Dd, Dd, Dd, Rp, Rp, Qxe, Qxe, Dd^Fdw, Rd, Rd, Rp, Kh, Ch, Gg, Gg, Gg, Wot^Bsb\, Wot
Hh, Hh, Gll^Fp, Gg, Gg, Dd, Dd, Dd, Dd, Rp, Rp, Rd, Rr^Dr, Hd, Rd^Fetd, Dd, Dd, Qxe, Dd, Dd, Qxe, Dd^Fdw, Rp, Rp, Dd^Fdw, Dd^Fdw, Qxe, Wot, Wot, Wot, Wot, Wot^Bsb\
Gll^Fp, Gll^Fp, Gll^Fp, Gg, Gg, Gg, Ch, Rd, Rd^Dr, Dd, Dd, Rd, Rd, Rd, Dd, Dd, Dd^Dc, Dd, Dd^Fdw, Dd^Fdw, Qxe, Rp, Rp, Rd^Dr, Qxe, Qxe, Qxe, Qxe, Wot, Wot, Gg, Gg
Gll^Fp, Gll^Fp, Gll^Fp, Gg, Gg, Gg, Ch, Rd, Rp, Rp, Dd, Dd, Hd, Dd, Dd, Dd, Dd, Dd, Dd, Qxe, Qxe, Rd, Qxe, Qxe, Qxe, Qxe, Ch, Gg, Gg, Gg, Gg, Rp
Gll^Fp, Gll^Fp, Gll^Fp, Gg, Gg, Gg, Ch, Rd, Rd^Dr, Rd^Dr, Rp, Rb^Fetd, Rp, Dd, Dd, Rr^Dr, Dd, Dd, Qxe, Qxe, Qxe, Qxe, Qxe, Qxe, Rp, Rp, Ch, Gg, Gg, Gg, Gg, Rp
Gll^Fp, Gll^Fp, Gll^Fp, Gg, Gg, Gg, Ch, Rd, Rd, Rd, Rp, Rp, Dd, Dd, Rd, 2 Dd^Fdw, Qxe, Qxe, Qxe, Qxe, Dd, Rd, Rp, Rp, Rp, Rd^Fdw, Ch, Gg, Gg, Gg, Rp, Rp
Gll^Fp, Gll^Fp, Gll^Fp, Gg, Gg, Gg, Ch, Rd, Rp, Rp, Rd^Dr, Rd^Dr, Dd, Rp, 1 Rp, Dd^Fdw, Qxe, Qxe, Rr^Dr, Dd^Fdw, Dd^Fdw, Rp, Rd^Fdw, Rd^Fdw, Rp, Kh, Kh, Gg, Gg, Gg, Rp, Hh
Gll^Fp, Gll^Fp, Gll^Fp, Gg, Gg, Gg, Rp, Rr^Dr, Ch, Rd, Dd, Dd, Dd, Re^Dr, Dd^Fdw, Qxe, Qxe, Qxe, Rd^Fdw, Rd, Dd, Dd^Fdw, Rd, Rd, Rr^Pr/, Ch, Gg, Gg, Gg, Gg, Rp, Hh
Gll^Fp, Gll^Fp, Gll^Fp, Gll^Fp, Rp, Rp, Gg, Gg, Dd, Dd, Ch, Dd, Dd, Dd, Dd^Fdw, Qxe, Qxe, Qxe, Rd^Fdw, Rd, Rd, Dd, Dd, Ch, Gg, Rp, Rp, Gg, Rp, Rp, Hh, Hh
Gg, Gll^Fp, Gll^Fp, Gll^Fp, Rp, Gg, Gg, Gg, Gg, Dd, Gg, Ch, Dd, Dd, Dd^Fdw, Qxe, Qxe, Qxe, Rd^Fdw, Rd, Ch, Dd, Dd, Gg, Gg, Gg, Gg, Rp, Rp, Hh, Gll^Fp, Hh
Rp, Gll^Fp, Rp, Rp, Rp, Gg, Gg, Gg, Gg, Gg, Gg, Dd, Dd, Ch, Ch, Dd^Fdw, Qxe, Qxe, Ch, Ch, Gg, Dd, Gg, Gg, Gg, Gg, Gg, Gg, Hh, Rp, Rp, Hh
Rp, Rp, Gll^Fp, Gll^Fp, Rp, Gg, Hh, Gg, Gg, Gg, Gg, Dd, Gg, Gg, Gg, Ch, Qxe, Ch, Wot, Gg, Gg, Gg, Gg, Gg, Gg, Gg, Hh, Hh, Hh, Hh, Hh, Rp
Gg, Gll^Fp, Gll^Fp, Gll^Fp, Gll^Fp, Rp, Rp, Hh, Hh, Gg, Gg, Gg, Gg, Gg, Gg, Wot, Wot, Wot, Wot, Gg, Gg, Gg, Gg, Gg, Hh, Hh, Gll^Fp, Hh, Hh^Efm, Gll^Fp, Hh, Hh
Gll^Fp, Gll^Fp, Gll^Fp, Gll^Fp, Gll^Fp, Gll^Fp, Gll^Fp, Rp, Gs^Vh, Hh, Gg, Gg, Gg, Gg, Gll^Fp, Wot, Wot, Wot, Wot, Gll^Fp, Gll^Fp, Gg, Hh, Hh, Hh, Hh, Hh, Hh^Efm, Gll^Fp, Hh, Hh, Hh
Gll^Fp, Gll^Fp, Gll^Fp, Gll^Fp, Gll^Fp, Gll^Fp, Gll^Fp, Gll^Fp, Gg, Hh, Hh, Gg, Gg, Gg, Gll^Fp, Gll^Fp, Wot, Wot, Wot, Gll^Fp, Gll^Fp, Gg, Hh, Hh, Hh, Hh, Gll^Fp, Hh, Hh, Hh, Hh, Hh
Gg, Gll^Fp, Gll^Fp, Gll^Fp, Gg, Gll^Fp, Gll^Fp, Gll^Fp, Gg, Gg, Gg, Gg, Gg, Gg, Gg, Gll^Fp, Wot, Wot, Wot, Wot, Gg, Gg, Hh, Hh, Hh, Hh, Hh, Hh, Hh, Hh, Hh, Hh
